1111111111111111111
1111P00011111111111
1111110011111111111
1000C00011C0000C001
1011100110101000001
1C0000C00000C000001
1000C11111110000001
111111111111100C111
1111111111111E11111
1111111111111111111
