1111111111111111111111
11P00000000C0000000011
1111110C11101111111011
1111110111101111111011
11111100C00000C1111011
11110C0111101111111011
10000000000C0000C01011
111111111111100C111011
1E0000000C000C00000011
1111111111111111111111
